
SO ./textures/Purple.png

NO ./textures/Green.png

EA ./textures/Blue.png

WE ./textures/Gray.png
				


C 203,238,243

F 244,156,187

    1111111111111111111111111
    1000000000000000000100001
    1001000000000000000001111
11111000000000000001000001
111111000000000E0001000001
1001000000100000001000001
1001000000000000001000001
1001000000001000001000001
1111111111111111111111111