
SO ./textures/texture_4.png

NO ./textures/cagalhao.png

EA ./textures/texture_6.png

WE ./textures/texture_10.png



C 223,227,238

F 25,82,42

		1111111111111111111111111
1111111110110S0001110000000000001
111000000000000000000000000000001
111111111111111111111111111111111