
EA ./path_to_the_south_texture

NO ./path_to_the_north_texture

SO ./path_to_the_east_texture

WE ./path_to_the_west_texture



C 225,30,0

F 220,100,0

		1111111111111111111111111
		2000000000110000000000001
		3011000001110000000000001
		4001000000000000000000001
111111115011000001110000000000001
100000006011000001110111111111111
11110111711111011100000010001
11110111811111011101010010001
11000000910101011100000010001
10000000000000001100000010001
10000000000000001101010010001
11000001110101011111011110S0111
11110111 1110101 101111010001
11111111 1111111 111111111111