
SO ./path_to_the_south_texture

NO ./path_to_the_north_texture

EA ./path_to_the_east_texture

WE ./path_to_the_west_texture



C 25,20,175

F 255,100,200

		1111111111111111111111111
		1000000000110000000000001
		1011000001110000000000001
		1001000000000000000000001
111111111011000001110000000000001
100000000011000001110111111111111
11110111111111011100000010001
11111111111111011101S10010001
11000000110101011100000010001
111111111110000001100000010001
1000001   10000001101010010001111
11000111  1001011111011110W01101
11110111  110101  11111010001111
11111111  1111111 1111111111111